DIMENSIONS:50x50
FLOOR:FLOOR_TILES0
WALLS:RED_WALL_TILES
??????????????????????????????????????????????????
??????????????????????????????????????????????????
??????????????????????????????????????????????????
??????????????????????????????????????????????????
??????????????????????????????????????????????????
??????????????????????????????????????????????????
??????????????????????????????????????????????????
??????????????????????????????????????????????????
??????????????????????????????????????????????????
??????????????????????????????????????????????????
??????????????????????????????????????????????????
??????????????????????????????????????????????????
??????????????????????????????????????????????????
??????????????????????????????????????????????????
??????????????????????????????????????????????????
??????????????????????????????????????????????????
???????????????????allll#lllb?????????????????????
???????????????????R########L?????????????????????
???????????????????R########L?????????????????????
???????????????????R########L?????????????????????
???????????????????R########L?????????????????????
???????????????alll#########L?????????????????????
???????????????R############L?????????????????????
???????????????R############L?????????????????????
???????????????R############L?????????????????????
???????????????R############L?????????????????????
???????????????R#############lllllb???????????????
???????????????R##################L???????????????
???????????????R##################L???????????????
???????????????R##################L???????????????
???????????????R##################L???????????????
???????????????R##################L???????????????
???????????????dhhhhhhhhhhhhhhhhhhc???????????????
??????????????????????????????????????????????????
??????????????????????????????????????????????????
??????????????????????????????????????????????????
??????????????????????????????????????????????????
??????????????????????????????????????????????????
??????????????????????????????????????????????????
??????????????????????????????????????????????????
??????????????????????????????????????????????????
??????????????????????????????????????????????????
??????????????????????????????????????????????????
??????????????????????????????????????????????????
??????????????????????????????????????????????????
??????????????????????????????????????????????????
??????????????????????????????????????????????????
??????????????????????????????????????????????????
??????????????????????????????????????????????????
??????????????????????????????????????????????????
